2 15 8 8 8 8 16 3 3 3 3 3 3 3 3 3 3 3 3 3 3 3 3 5 10 2 2 2 2 2 2 2 2 18 17 2 2 2 2 2 2 2 2 2 2 2 2 2 2 2 2 
2 18 7 7 7 7 17 2 2 18 3 17 2 2 2 2 2 2 2 2 2 9 5 14 17 2 2 2 2 2 2 2 2 2 2 2 2 2 2 2 2 2 2 2 2 2 2 2 2 2 2 
2 2 2 2 2 2 2 2 2 2 3 2 2 2 2 2 2 2 2 2 2 9 5 10 2 2 2 2 2 2 2 2 2 2 2 2 2 2 2 2 2 2 2 2 2 2 2 2 2 2 2 
2 2 2 2 15 16 2 2 2 2 3 2 2 2 15 8 8 16 2 2 2 9 5 10 2 2 2 2 15 8 16 2 2 2 2 15 16 2 2 2 2 2 2 2 2 2 15 8 8 16 2 
2 2 15 8 12 10 2 2 2 2 3 2 2 2 9 5 14 17 2 2 15 12 5 11 16 2 15 8 12 5 10 2 2 15 8 12 10 2 2 15 8 8 16 2 2 2 9 5 5 10 2 
8 8 12 3 3 10 2 2 15 8 3 8 16 2 18 7 17 2 2 2 9 5 5 0 11 8 12 0 0 5 11 8 8 12 5 5 11 8 8 12 0 0 11 8 8 8 12 0 5 11 8 
3 3 3 3 3 10 2 2 9 5 3 5 10 2 2 2 2 2 15 8 12 0 0 0 0 5 5 0 0 0 0 0 0 0 0 4 0 0 0 0 0 0 0 0 5 5 0 0 0 0 0 
3 3 3 3 3 10 2 2 18 3 3 3 11 8 8 8 8 8 12 1 0 0 0 0 0 0 0 0 0 0 0 0 0 0 0 4 0 0 0 4 0 0 0 0 0 0 0 0 0 0 0 
7 7 13 3 3 3 3 3 3 3 3 3 3 3 3 3 3 3 3 1 0 0 0 0 0 0 0 0 0 4 0 0 0 0 0 0 4 0 0 0 0 0 0 0 0 0 0 0 0 0 0 
2 2 9 3 3 3 3 3 3 3 3 3 3 3 3 3 3 3 3 3 1 0 0 0 0 0 0 0 0 0 0 4 0 0 0 0 0 0 0 0 0 0 0 0 4 0 0 0 4 0 0 
2 2 18 13 5 10 2 2 2 3 3 3 9 3 10 2 2 2 3 3 3 1 0 0 5 5 0 0 0 0 0 0 0 0 0 0 0 4 0 0 0 0 0 0 0 4 0 0 0 0 0 
16 2 2 18 7 17 2 2 2 2 2 2 9 3 10 2 2 2 2 3 3 3 1 0 0 0 0 4 0 0 0 0 0 0 0 0 0 4 4 0 0 0 0 0 0 4 0 0 0 0 0 
10 2 2 2 2 2 15 8 16 2 2 2 9 3 10 2 2 2 15 1 1 3 3 1 0 0 0 0 0 0 0 0 0 0 0 0 0 0 0 0 0 4 0 0 0 0 0 0 0 0 4 
11 8 16 2 2 2 9 5 10 2 2 2 9 3 10 2 2 2 9 5 1 1 3 3 1 0 0 0 4 4 0 0 0 0 0 0 0 0 4 4 0 0 0 0 0 0 0 0 0 0 0 
5 5 11 16 2 2 9 5 11 16 2 2 9 3 10 2 2 2 9 5 4 0 1 3 3 1 0 0 0 0 0 0 0 0 0 0 0 0 0 0 0 0 0 0 0 0 0 0 0 0 0 
0 0 5 10 2 2 18 7 13 3 3 3 3 3 11 16 2 2 18 13 0 0 0 1 3 3 1 0 0 0 4 0 0 0 0 0 0 0 0 0 0 0 0 0 0 0 0 0 0 0 4 
0 0 5 10 2 2 2 2 18 3 2 2 2 18 7 17 2 2 2 9 0 0 0 0 1 3 3 1 0 0 0 0 0 0 0 0 0 4 0 0 0 0 4 0 0 0 0 0 4 0 0 
0 0 5 11 16 2 2 2 2 3 2 2 2 2 2 2 2 2 2 18 13 0 0 0 0 1 3 3 1 0 0 0 4 4 0 0 0 0 0 0 0 0 0 0 0 0 0 0 0 0 0 
5 0 5 5 11 8 16 2 2 3 2 2 2 15 8 8 16 2 2 2 9 4 0 0 0 0 1 3 3 1 0 0 0 1 1 1 1 0 0 0 0 0 1 1 1 1 0 0 0 0 0 
5 5 14 7 7 13 11 16 2 3 2 2 2 9 3 3 10 2 2 2 9 0 4 0 0 0 0 1 3 3 1 0 1 1 3 3 1 1 1 0 1 1 1 3 3 1 1 0 0 0 0 
5 5 10 2 2 9 3 3 3 3 3 3 3 3 3 3 10 2 15 8 12 0 0 0 0 0 0 0 1 3 3 1 1 3 3 3 3 3 1 1 1 3 3 3 3 3 1 1 0 0 0 
5 5 10 2 2 9 3 3 3 3 3 2 2 18 7 3 17 2 9 5 4 0 4 0 0 0 0 0 0 1 3 3 3 3 3 3 3 3 3 1 3 3 3 3 3 3 3 1 1 0 0 
0 0 10 2 2 18 17 2 2 2 2 2 2 2 2 3 2 2 18 13 0 0 0 0 4 0 0 0 0 0 1 3 3 1 3 3 1 3 3 1 3 3 1 3 3 1 3 3 1 0 0 
0 0 10 2 2 15 8 8 8 8 16 2 2 2 2 3 15 8 16 9 0 0 0 0 0 0 0 0 0 0 1 3 3 3 3 3 3 3 1 3 3 3 3 3 3 3 3 3 1 0 0 
0 5 10 2 2 9 5 5 5 5 10 2 2 15 8 3 12 5 10 9 0 0 0 0 0 0 0 0 0 0 1 3 3 3 3 3 3 3 3 1 3 1 3 3 1 3 3 3 1 0 0 
0 5 10 2 2 9 14 7 7 13 10 2 2 9 5 3 14 7 17 9 0 0 0 0 0 0 0 0 0 0 1 3 3 1 3 3 3 1 1 3 3 3 3 3 3 3 3 3 1 0 14 
0 5 11 8 8 12 11 16 2 18 17 2 15 12 0 0 10 2 2 9 0 0 0 0 0 4 0 0 0 4 1 3 3 3 3 1 3 3 1 3 3 3 1 3 1 3 1 3 1 0 10 
5 5 0 0 0 0 0 10 2 2 2 2 9 0 0 0 11 8 8 12 0 0 0 0 0 0 0 0 0 0 1 3 1 1 1 1 3 3 1 1 3 1 3 3 3 3 1 3 1 14 17 
0 0 0 0 0 0 0 11 8 16 2 2 9 0 0 0 0 0 0 0 0 0 4 0 0 0 0 0 0 0 0 1 3 3 3 3 3 1 3 3 3 1 3 3 1 3 3 1 0 10 2 
0 0 0 0 0 0 0 0 0 3 3 3 3 0 0 0 0 0 0 0 0 0 0 0 4 0 0 0 0 0 0 1 3 3 3 1 1 1 3 1 1 3 3 3 3 1 3 1 0 10 2 
0 0 0 0 0 0 0 0 0 3 3 3 3 0 4 0 4 0 0 0 0 0 0 0 0 0 0 0 0 0 0 1 1 3 3 3 3 3 3 1 3 1 3 3 3 3 1 1 14 17 2 
0 0 0 0 0 0 0 14 7 17 2 2 9 0 0 0 0 0 0 0 0 0 4 0 0 0 0 4 0 4 0 0 1 1 3 3 3 1 3 1 3 3 3 1 3 1 1 0 10 2 2 
4 0 0 0 0 0 14 17 2 2 2 2 18 7 7 13 0 0 0 0 0 0 0 0 0 4 0 0 4 0 0 0 5 1 3 3 3 3 3 1 3 1 3 3 3 3 0 0 10 2 2 
0 0 4 0 0 0 10 2 2 2 2 2 2 2 2 9 0 0 0 0 0 0 0 0 0 0 0 0 0 0 0 0 5 1 1 3 3 3 3 1 3 3 3 3 1 3 3 14 17 2 2 
0 0 0 0 0 0 10 2 2 2 2 2 2 2 2 9 0 0 0 4 0 0 0 0 0 0 0 0 0 0 0 0 0 0 1 1 3 3 1 3 3 3 3 1 1 3 3 10 2 2 2 
0 0 0 0 0 0 11 8 8 8 16 2 2 15 8 12 4 4 0 0 0 0 0 0 0 0 0 0 0 0 0 0 0 5 5 1 1 3 3 1 3 3 1 1 0 3 14 17 2 2 15 
0 4 0 0 0 4 0 5 5 14 17 2 2 9 0 0 0 0 0 4 0 0 0 0 0 0 0 4 4 0 0 0 0 0 5 0 1 1 1 3 1 1 1 0 0 3 10 2 2 15 12 
0 0 4 0 0 0 0 0 14 17 2 2 15 12 0 0 0 0 0 0 0 4 0 0 0 4 0 0 0 0 0 0 0 0 0 4 0 0 1 1 1 0 0 0 0 3 10 2 2 9 5 
4 0 0 0 0 0 0 0 10 2 2 2 9 5 0 0 0 0 0 0 0 0 0 0 0 0 0 0 0 0 0 0 0 4 0 0 0 0 0 1 0 0 0 0 0 3 10 2 2 9 0 
0 0 0 0 0 0 0 0 11 16 2 2 18 7 7 7 7 7 7 7 7 7 7 7 7 7 7 7 7 7 7 7 7 7 7 7 7 7 7 7 7 7 7 7 13 3 10 2 2 9 0 
5 5 5 5 5 5 5 5 5 10 2 2 2 2 2 2 2 2 2 2 2 2 2 2 2 2 2 2 2 2 2 2 2 2 2 2 2 2 2 2 2 2 2 2 9 3 3 3 3 3 3 
0 0 4 0 0 0 0 0 4 10 2 2 2 2 2 2 2 2 2 2 2 2 2 2 2 2 2 2 2 2 2 2 2 2 2 2 2 2 2 2 2 2 2 2 18 3 17 2 2 9 1 
0 0 0 0 0 0 0 0 14 17 2 2 15 8 8 8 8 8 8 8 8 8 8 8 8 8 8 8 8 8 8 8 8 16 2 2 2 2 2 2 2 2 2 2 2 3 2 2 2 9 1 
0 0 0 0 0 0 0 14 17 2 2 2 9 0 0 0 0 0 0 0 0 0 0 0 0 0 0 0 0 0 0 0 0 11 8 16 2 2 2 2 2 2 2 2 2 3 2 2 2 9 1 
4 0 0 0 0 0 14 17 2 2 2 15 12 0 4 0 0 1 1 1 1 1 1 1 1 1 0 0 0 0 0 0 0 0 0 11 8 16 2 2 2 2 2 2 2 3 2 2 2 9 1 
5 5 3 3 5 14 17 2 2 2 15 12 0 0 0 0 0 1 5 5 5 1 5 5 5 1 0 0 0 0 0 0 0 4 0 0 0 11 8 16 2 2 2 2 2 3 2 2 2 9 1 
7 7 3 3 7 17 2 2 2 2 9 0 0 0 0 0 0 1 5 5 5 1 5 5 5 1 0 0 0 0 0 0 0 0 0 0 0 0 0 11 8 16 2 2 2 3 2 2 2 9 1 
2 2 3 3 2 2 2 2 2 15 12 0 0 0 0 0 0 1 1 5 1 1 1 5 1 1 0 0 0 0 0 0 0 0 0 0 0 0 0 0 0 11 16 2 2 3 2 2 2 9 1 
2 2 3 3 2 2 2 2 2 9 0 0 0 0 4 0 0 1 5 5 5 5 5 5 5 1 0 0 0 0 0 0 4 0 0 0 0 0 0 0 0 0 10 2 15 3 16 2 15 12 1 
2 2 3 3 2 2 2 2 15 12 0 0 0 0 0 0 0 1 5 5 5 5 5 5 5 1 0 4 0 0 0 0 0 0 0 0 0 0 0 0 0 0 3 3 3 3 3 3 3 5 1 
2 2 3 3 2 2 2 2 9 0 0 0 0 0 0 0 4 1 5 5 5 5 5 5 5 1 0 0 0 0 0 0 0 0 0 0 0 0 0 0 0 0 10 2 18 7 17 2 18 13 1 
