2 2 2 2 2 2 2 2 2 2 2 2 2 2 2 2 2 2 2 2 2 2 2 2 2 2 2 2 2 2 2 2 2 2 2 2 2 2 2 2 2 2 2 2 2 2 2 
2 2 2 2 2 2 2 2 2 2 2 2 2 2 2 2 2 2 2 2 2 2 2 2 2 2 2 2 2 2 2 2 2 2 2 2 2 2 2 2 2 2 2 2 2 2 2 
2 2 2 2 2 2 2 2 2 2 2 2 2 2 2 2 2 2 2 2 2 2 2 2 2 2 2 2 2 2 2 2 2 2 2 2 2 2 2 2 2 2 2 2 2 2 2 
2 2 2 2 2 2 2 2 2 2 2 2 2 2 2 2 2 2 2 2 2 2 2 2 2 2 2 2 2 2 2 2 2 2 2 2 2 2 2 2 2 2 2 2 2 2 2 
2 2 2 2 2 2 2 2 2 2 2 2 2 2 2 2 2 2 2 2 2 2 2 2 2 2 2 2 2 2 2 2 2 2 2 2 2 2 2 2 2 2 2 2 2 2 2 
2 2 2 2 2 2 2 2 2 2 2 2 2 2 2 2 2 2 2 2 2 2 2 2 2 2 2 2 2 2 2 2 2 2 2 2 2 2 2 2 2 2 2 2 2 2 2 
2 2 2 2 2 2 2 2 2 2 2 2 2 2 2 2 2 2 2 2 2 2 2 2 2 2 2 2 2 2 2 2 2 2 2 2 2 2 2 2 2 2 2 2 2 2 2 
2 2 2 2 2 2 2 2 2 2 2 2 2 2 2 2 2 2 2 2 2 2 2 2 2 2 2 2 2 2 2 2 2 2 2 2 2 2 2 2 2 2 2 2 2 2 2 
2 2 2 2 2 2 2 2 15 8 8 8 8 8 8 8 8 8 8 8 8 8 8 8 8 8 8 8 8 16 2 2 2 15 8 16 2 2 15 8 16 2 2 2 2 2 2 
2 2 2 2 2 2 2 2 9 3 3 3 5 5 5 5 5 3 3 3 3 3 3 3 5 5 3 3 3 11 16 2 2 9 3 10 2 2 9 3 10 2 2 2 2 2 2 
2 2 2 2 2 2 2 2 9 3 0 0 3 5 14 7 7 7 7 13 3 14 7 7 7 13 3 0 0 3 11 16 2 9 3 10 2 2 9 3 10 2 2 2 2 2 15 
2 2 2 2 2 2 2 2 9 3 0 0 0 3 10 2 2 2 2 9 3 10 2 2 2 9 3 0 0 0 3 10 2 9 3 10 2 2 9 3 10 2 2 2 2 3 3 
2 2 2 2 2 2 2 2 9 3 0 0 0 3 11 16 2 2 2 9 3 10 2 2 2 9 3 0 0 0 3 11 16 9 3 10 2 2 9 3 10 2 2 2 2 2 18 
2 2 2 2 2 2 2 15 12 3 0 0 0 0 3 10 2 2 2 9 3 10 2 2 2 9 3 0 0 0 0 3 11 12 3 11 8 8 12 3 10 2 2 2 2 2 2 
2 2 2 2 2 2 2 9 3 3 3 0 0 0 3 10 2 2 2 9 3 10 2 2 2 9 3 0 0 0 0 3 5 5 3 3 3 3 3 3 10 2 2 2 2 2 2 
2 2 2 2 2 2 2 18 13 3 0 0 0 0 3 10 2 2 2 9 3 10 2 2 2 9 3 0 0 0 0 3 14 13 3 14 7 7 13 3 10 2 2 2 2 2 2 
2 2 2 2 2 2 2 2 9 3 0 0 0 3 5 10 2 2 2 9 3 10 2 2 2 9 3 0 0 0 3 14 17 9 3 10 2 2 9 3 10 2 2 2 2 2 2 
2 2 2 2 2 2 2 2 9 3 0 0 0 3 14 17 2 2 2 9 3 10 2 2 2 9 3 0 0 0 3 10 2 9 3 10 2 2 9 3 10 2 2 2 2 2 2 
2 2 2 2 2 2 2 2 9 3 0 0 3 5 10 2 2 2 2 9 3 10 2 2 2 9 3 0 0 3 14 17 2 9 3 10 2 2 9 3 10 2 2 2 2 2 2 
2 2 2 2 2 2 2 2 9 3 3 3 14 7 17 2 2 2 2 9 3 10 2 2 2 9 3 3 3 5 10 2 2 9 3 10 2 2 9 3 10 2 2 2 2 2 2 
2 2 2 2 2 2 2 2 18 7 7 7 17 2 2 2 2 2 2 9 5 11 8 8 8 12 5 14 7 7 17 2 2 18 7 17 2 2 18 7 17 2 2 2 2 2 2 
2 2 2 2 15 8 16 2 2 15 8 8 16 2 2 2 2 2 2 9 3 3 3 3 3 3 3 10 2 2 15 16 2 2 2 2 2 15 16 2 2 2 15 16 2 2 2 
16 2 15 8 12 5 10 2 2 9 5 5 10 2 2 15 8 8 8 1 1 1 1 1 1 3 1 1 16 2 9 10 2 2 15 8 8 12 10 2 15 8 12 11 16 2 15 
11 8 12 0 0 5 11 8 8 12 5 5 11 16 2 9 0 0 5 5 5 5 5 1 1 3 3 1 11 8 12 11 8 8 12 1 1 5 11 8 12 5 5 5 11 8 12 
0 5 5 0 0 0 0 0 0 0 0 0 0 10 2 9 0 0 0 5 5 5 1 1 3 1 3 1 1 1 1 1 1 1 1 1 1 1 5 5 5 1 1 1 1 5 5 
