16 2 2 2 2 2 2 9 3 3 3 3 3 3 3 10 2 2 15 16 2 2 2 2 2 15 16 2 2 2 15 16 2 2 2 3 2 9 10 2 2 2 2 2 2 
10 2 2 15 8 8 8 1 1 1 1 1 1 3 1 1 16 2 9 10 2 2 15 8 8 12 10 2 15 8 12 11 16 2 15 3 8 12 11 8 16 2 2 2 2 
11 16 2 9 0 0 5 5 5 5 5 1 1 3 3 1 11 8 12 11 8 8 12 1 1 5 11 8 12 5 5 5 11 8 12 3 0 5 5 5 11 16 2 2 2 
0 10 2 9 0 0 0 5 5 5 1 1 3 1 3 1 1 1 1 1 1 1 1 1 1 1 5 5 5 1 1 1 1 5 5 3 0 0 14 7 13 10 2 15 16 
0 10 2 9 0 0 4 5 5 1 1 3 3 1 3 3 3 3 3 3 3 3 1 3 3 1 1 1 1 1 3 3 1 1 1 3 1 1 10 2 9 10 2 9 10 
7 17 2 18 13 0 0 5 0 1 3 1 3 3 1 1 1 1 1 1 1 3 3 3 1 1 3 3 3 1 3 3 3 3 3 3 3 1 11 8 12 11 8 12 10 
2 2 2 2 9 4 0 0 0 1 3 3 1 3 3 1 3 3 3 3 1 1 1 3 3 3 1 1 3 1 3 1 1 3 3 1 1 1 1 1 0 0 0 5 11 
2 2 2 2 9 0 0 0 0 1 3 1 1 3 3 3 3 1 1 3 3 3 1 3 1 3 3 1 3 1 3 1 3 3 1 1 3 3 3 1 4 0 0 0 5 
8 8 8 8 12 0 4 0 0 1 3 1 3 1 3 1 1 3 1 1 1 3 3 1 1 3 1 1 3 1 3 1 3 1 3 3 3 1 3 3 0 0 0 0 0 
0 0 0 0 0 4 0 0 0 1 3 3 3 3 1 3 1 3 1 3 1 1 3 3 3 3 3 3 3 1 3 1 3 3 1 3 1 1 3 1 14 7 7 13 0 
0 0 3 3 3 3 3 3 0 1 1 1 3 3 3 3 1 3 1 3 1 3 3 3 1 1 3 1 3 3 3 1 3 3 3 3 3 1 3 1 10 2 2 9 0 
0 0 3 0 0 0 0 3 0 1 3 3 3 1 1 3 1 3 3 3 1 3 1 1 3 1 1 3 3 3 1 3 1 3 1 3 3 1 3 1 1 1 2 18 13 
0 0 3 0 0 0 0 3 0 1 1 3 1 3 3 3 3 1 3 1 3 3 1 3 3 3 1 1 3 1 3 3 3 3 1 3 1 1 3 3 3 1 2 2 18 
0 0 3 3 3 3 3 3 0 1 3 3 1 3 1 1 3 1 3 1 3 3 3 1 3 3 3 1 1 3 3 1 1 3 1 3 3 1 1 1 3 1 2 2 2 
0 0 3 5 5 5 5 3 0 1 1 3 3 1 3 3 3 3 3 3 1 3 3 1 3 1 3 3 1 3 1 3 3 1 3 3 3 3 3 1 3 1 8 8 16 
0 0 3 5 5 5 5 3 0 1 1 3 1 1 3 3 1 1 1 3 3 1 1 1 3 3 1 3 3 3 3 1 3 1 1 1 1 1 3 1 3 1 0 0 10 
0 4 3 5 5 5 5 3 0 1 3 3 3 3 1 3 3 3 1 1 1 3 3 3 3 1 3 1 3 1 1 1 3 3 3 3 1 1 3 1 3 1 0 0 11 
0 0 3 3 3 3 3 3 0 1 3 1 1 1 1 1 3 3 3 3 1 1 1 1 1 1 3 1 3 3 3 3 3 1 1 3 3 3 3 1 3 1 0 0 0 
0 0 0 0 0 0 0 0 0 1 3 3 3 3 3 1 3 1 3 1 1 3 3 3 3 3 3 1 1 1 3 3 1 3 1 1 1 1 1 1 3 1 0 0 0 
0 0 0 0 0 0 0 4 0 1 3 1 1 3 1 3 3 1 1 3 1 3 1 1 3 1 1 1 1 3 1 3 3 3 1 3 3 3 1 3 3 1 0 4 0 
0 0 0 0 0 4 0 0 0 1 3 3 1 3 1 1 3 1 3 3 1 3 1 3 3 1 3 1 3 3 1 3 1 3 3 3 1 3 1 3 1 1 0 4 4 
0 0 0 0 0 0 0 4 0 1 3 1 1 3 1 3 3 1 3 1 3 3 1 3 3 3 3 1 3 1 1 3 1 3 1 1 1 3 1 3 1 0 0 0 0 
0 0 4 0 0 0 0 0 4 1 1 3 3 3 1 3 1 1 3 3 3 1 3 1 3 1 3 3 3 3 3 3 3 1 3 3 1 3 3 3 1 4 0 0 0 
0 0 0 4 0 0 0 0 0 1 1 3 1 1 1 3 3 3 3 1 3 3 3 3 1 3 3 1 3 1 1 1 3 1 3 1 1 1 1 1 1 0 0 0 0 
0 4 0 0 0 0 0 0 5 1 1 3 3 1 1 1 3 3 1 3 1 1 1 1 3 3 1 1 1 3 3 3 1 3 3 3 3 1 3 3 5 0 0 0 0 
0 0 4 0 0 0 0 0 5 3 3 1 3 1 3 3 3 1 1 3 3 3 1 3 1 3 3 1 3 3 1 3 1 3 1 1 3 3 3 3 5 0 0 0 0 
0 0 0 0 0 0 0 0 5 1 3 3 3 3 3 1 3 3 1 3 1 3 3 3 3 3 1 3 3 1 3 3 3 3 3 3 1 1 1 1 1 0 0 0 4 
4 0 0 0 0 0 0 0 0 1 3 1 3 1 1 3 3 1 3 1 3 3 1 1 1 3 1 3 1 3 1 1 3 3 1 1 3 3 3 3 1 1 1 4 0 
0 4 0 0 0 4 0 0 0 1 3 1 1 3 3 3 3 3 3 1 3 1 3 1 3 3 1 3 3 3 1 3 3 1 3 3 3 0 0 3 3 3 3 1 1 
0 0 0 0 0 0 0 0 0 1 3 3 3 3 1 1 3 1 3 1 3 3 3 1 1 1 3 1 3 1 3 3 1 3 3 0 0 4 0 0 0 1 3 3 3 
0 4 0 0 4 0 0 0 0 1 1 3 1 3 3 1 3 3 1 1 1 1 3 1 3 3 3 3 3 1 3 1 3 3 0 0 4 0 0 1 1 3 3 3 3 
0 0 0 0 0 0 0 0 0 1 3 1 3 3 1 3 1 3 3 3 3 1 3 1 3 1 1 3 1 1 1 3 3 0 0 0 0 0 1 3 3 3 0 0 1 
4 4 0 0 0 4 0 4 0 1 3 3 3 1 3 3 3 1 3 1 3 1 3 3 3 3 1 3 3 1 3 3 0 0 0 0 0 1 3 3 1 0 0 0 1 
0 0 0 0 4 0 4 0 0 1 3 1 1 3 3 1 1 1 3 1 3 3 1 3 3 1 3 3 1 3 3 0 0 0 0 0 1 3 3 1 0 0 0 0 1 
0 4 0 0 0 0 0 0 0 1 3 1 3 3 1 3 3 3 3 1 3 1 3 3 1 3 3 1 3 3 0 0 0 4 0 1 3 3 1 0 0 0 0 0 1 
0 0 0 0 0 0 0 0 0 1 3 1 3 1 3 3 1 1 1 3 3 3 3 1 3 3 1 3 3 0 0 0 0 4 0 1 3 3 1 0 0 0 0 0 1 
0 0 0 0 0 0 0 4 0 1 3 3 3 1 1 3 3 3 1 3 3 1 1 3 3 1 3 3 0 0 0 0 0 0 4 1 3 3 1 0 0 0 0 0 0 
0 4 0 4 0 0 0 0 0 1 1 1 3 3 3 1 1 3 1 1 1 3 3 3 1 3 3 0 0 4 0 0 0 0 4 0 1 3 1 0 0 0 0 0 0 
0 5 0 0 3 3 3 3 3 3 3 3 1 1 3 3 3 3 1 3 3 3 1 1 3 3 0 0 0 0 0 0 0 0 0 0 1 3 1 0 0 0 0 0 0 
0 5 3 3 3 0 0 0 0 0 0 3 3 3 1 1 1 3 3 3 1 1 3 3 3 0 0 0 0 0 4 0 0 0 0 0 1 3 3 1 0 0 0 0 0 
0 3 3 0 0 0 0 0 0 0 0 0 0 3 3 3 3 1 3 1 3 3 3 0 0 0 0 0 0 0 0 0 0 0 0 0 0 1 3 3 1 0 0 0 0 
3 3 0 0 0 0 0 0 0 0 0 0 0 0 0 0 3 3 3 3 3 0 0 4 0 0 0 0 4 0 0 0 4 0 0 0 0 0 1 3 3 1 0 0 0 
