02 15 08 08 08 08 16 03 
02 18 07 07 07 07 17 02 
02 02 02 02 02 02 02 02 
02 02 02 02 15 16 02 02 
02 02 15 08 12 10 02 2 
