2 9 1 5 0 0 4 4 0 5 5 4 0 0 0 3 3 3 4 0 0 5 0 0 0 0 0 3 3 3 0 0 0 0 0 0 0 0 0 0 0 0 0 0 
15 12 1 0 0 0 5 0 0 5 5 5 0 0 0 0 4 3 3 3 0 5 0 0 0 3 3 3 0 0 0 0 0 0 0 0 0 0 0 0 0 0 0 0 
3 5 1 0 0 0 5 5 5 0 0 5 0 0 0 0 0 0 0 3 3 3 3 3 3 3 0 0 0 0 0 4 0 0 0 0 5 0 0 0 0 0 0 5 
18 13 1 4 5 5 5 5 0 0 0 5 0 0 0 0 0 5 5 4 0 5 4 0 0 0 0 0 0 0 0 0 4 0 0 0 5 0 0 0 0 0 5 0 
2 9 1 5 5 5 5 5 5 4 5 5 0 0 5 0 0 0 0 0 0 5 0 0 0 0 0 4 0 0 4 0 0 0 0 0 5 0 0 0 0 5 0 0 
2 9 1 5 5 5 5 5 5 0 5 5 0 0 5 0 0 0 0 0 0 5 0 0 0 4 0 0 0 0 0 0 4 0 0 0 5 0 0 0 0 5 0 0 
2 9 1 0 5 5 5 0 0 4 0 5 0 0 0 0 0 0 0 0 0 0 0 5 0 0 0 0 0 0 0 0 0 0 0 0 5 0 0 0 0 5 0 0 
2 9 1 4 5 0 0 0 0 0 0 0 0 0 0 0 0 0 0 0 0 5 5 5 4 0 4 0 0 4 0 0 0 0 0 0 5 0 0 0 0 5 0 0 
2 9 1 0 4 0 5 5 5 5 5 5 0 0 0 5 5 0 0 0 0 0 0 0 0 4 0 0 0 0 0 0 0 0 0 0 5 0 0 0 0 5 0 0 
2 9 1 4 0 0 5 6 5 5 5 5 5 0 0 0 4 0 0 5 0 0 0 0 0 0 0 0 0 0 0 0 0 0 0 0 5 0 0 0 0 5 0 0 
2 9 1 4 0 5 5 5 5 6 5 5 5 0 4 0 0 0 4 5 5 5 0 0 0 0 0 4 0 4 0 0 4 0 0 0 5 0 0 0 0 0 5 0 
2 9 1 5 5 5 5 6 5 5 6 5 4 0 0 0 0 5 5 5 5 4 0 0 0 0 0 0 0 0 0 4 4 0 0 0 5 5 5 5 5 0 0 5 
2 9 1 5 6 5 5 6 5 5 5 5 0 0 0 0 0 4 5 5 0 0 4 4 0 0 4 0 0 0 0 0 0 0 0 0 0 0 0 0 0 0 0 0 
2 9 1 5 5 5 5 5 5 0 0 4 4 0 0 0 0 0 5 5 4 0 4 4 4 4 4 4 0 0 0 0 4 4 0 0 4 4 4 4 4 4 4 4 
2 9 1 0 0 5 5 5 5 5 5 5 4 0 4 4 0 0 5 4 4 4 4 0 4 0 0 4 0 4 0 4 4 0 0 0 0 0 0 0 0 0 0 0 
2 9 1 5 5 5 5 0 4 4 5 4 4 4 0 0 0 0 0 0 0 0 4 4 4 4 4 4 0 0 4 0 4 0 4 4 0 0 4 4 0 4 0 4 
2 9 1 0 0 5 0 0 0 0 5 5 5 0 4 5 5 4 5 0 0 0 0 0 4 0 4 4 0 0 4 4 0 4 0 4 0 4 0 4 4 4 0 0 
2 9 1 5 0 6 5 5 4 0 4 4 0 0 4 0 0 4 5 0 4 4 4 4 0 4 4 4 4 0 4 4 4 4 4 0 0 0 0 4 4 4 0 4 
2 9 1 6 5 5 5 5 5 5 5 5 0 0 0 4 5 5 0 0 0 4 0 4 4 4 4 0 14 7 7 7 7 7 7 7 13 4 0 4 4 0 0 0 
8 12 1 5 5 6 5 5 6 5 5 5 5 5 0 0 0 0 0 0 0 0 4 4 14 7 7 7 17 15 8 8 8 8 8 16 18 7 7 7 7 7 7 7 
5 1 1 5 5 5 5 5 5 5 6 5 0 0 4 4 0 4 0 0 0 0 4 14 17 15 8 8 8 12 4 4 4 4 4 11 8 8 8 8 8 8 8 8 
0 5 5 0 5 5 5 5 5 5 5 0 0 4 4 0 0 4 0 0 0 4 0 10 15 12 0 4 4 4 0 0 0 4 0 0 4 4 0 4 0 4 0 0 
0 0 5 0 5 6 5 5 6 6 5 0 0 0 5 0 0 4 0 0 0 0 4 10 9 4 4 4 0 0 4 4 4 0 0 4 0 4 4 4 4 4 0 4 
0 5 6 4 0 5 5 5 5 6 5 5 5 5 5 5 5 5 5 5 5 5 5 3 3 5 5 5 0 0 4 4 4 4 0 4 0 0 4 4 0 4 0 0 
0 5 5 0 5 6 5 5 5 5 5 0 4 0 0 0 0 0 0 4 0 4 0 10 9 0 0 5 4 4 4 4 0 0 4 4 4 4 0 0 4 0 4 4 
0 0 5 5 5 5 5 5 5 0 0 0 4 0 5 5 5 5 5 5 0 0 14 17 9 4 4 5 0 0 4 0 4 4 4 4 4 0 4 4 4 5 5 5 
0 5 5 5 6 5 6 5 6 5 5 5 5 5 5 5 5 0 0 4 5 14 17 2 9 5 5 5 4 0 0 0 0 0 4 5 5 5 5 5 5 5 4 0 
0 5 5 5 5 5 5 5 5 0 0 5 0 0 0 14 7 7 7 7 7 17 2 15 12 4 4 5 0 0 4 4 5 5 5 5 4 0 4 4 0 0 4 4 
0 5 5 5 5 6 5 5 0 4 0 0 0 0 0 10 2 2 2 2 2 2 2 9 0 4 4 5 5 5 5 5 5 4 4 4 4 4 0 4 4 4 4 4 
0 0 0 0 5 6 5 5 5 0 0 0 4 0 0 10 2 15 8 8 8 8 8 12 4 0 4 4 0 4 0 4 0 4 0 4 4 4 0 4 4 4 4 0 
0 5 5 5 0 5 5 0 0 0 0 5 0 4 0 10 2 9 4 0 0 4 4 4 4 4 0 0 4 4 0 4 4 4 4 4 0 0 0 0 4 0 4 0 
13 6 5 5 0 5 5 0 0 0 5 5 5 0 4 10 2 9 0 0 4 4 4 4 0 0 0 0 4 4 0 0 4 0 4 4 4 4 4 4 0 4 4 0 
18 13 0 0 0 5 5 5 5 5 5 0 4 0 0 10 2 9 0 4 0 4 0 4 4 4 4 0 4 0 4 4 0 4 4 4 4 4 4 4 4 0 4 4 
2 18 7 7 13 5 5 5 5 5 5 0 0 0 0 10 2 9 4 0 0 4 4 4 4 0 4 4 4 0 0 4 4 4 4 0 4 4 14 7 7 7 7 7 
2 2 2 2 18 7 13 5 5 5 5 4 0 0 14 17 2 9 0 0 0 0 0 0 0 0 0 0 0 4 4 4 4 4 0 4 14 7 17 2 2 2 2 2 
2 2 2 2 2 2 18 13 5 5 5 4 0 14 17 2 2 9 0 0 0 0 4 4 4 4 4 4 4 4 4 4 4 14 7 7 17 2 2 15 8 8 8 8 
8 8 16 2 2 2 2 18 7 7 7 7 7 17 15 8 8 12 0 0 4 0 0 0 4 4 0 4 4 0 0 4 14 17 2 2 2 15 8 12 4 0 4 0 
0 1 11 8 16 2 2 2 15 8 16 2 2 2 9 5 5 0 0 0 0 4 0 4 0 4 0 4 4 0 4 14 17 2 15 8 8 12 0 0 4 4 4 4 
0 1 0 5 11 16 2 2 18 13 11 8 16 2 18 7 7 7 7 7 7 7 7 7 7 7 7 7 7 7 7 17 15 8 12 0 0 0 4 0 4 0 4 0 
0 3 0 0 3 3 3 3 3 3 3 0 11 8 8 16 2 2 2 2 2 2 2 2 2 2 2 2 2 2 2 2 9 14 7 7 13 0 0 0 0 0 0 0 
0 1 0 0 0 11 16 2 2 18 13 0 0 0 0 11 8 8 8 8 8 8 8 8 8 8 8 8 8 8 8 16 18 17 2 2 18 13 0 0 0 0 0 0 
0 1 0 0 0 0 11 16 2 2 9 0 0 0 0 0 0 0 0 0 0 0 0 0 0 0 4 0 0 0 0 11 8 8 8 16 2 18 13 0 0 0 0 0 
1 1 1 1 1 1 1 10 2 2 9 1 1 1 1 1 1 1 1 1 1 1 1 1 1 1 1 1 1 1 1 1 1 1 1 10 2 2 9 1 1 1 1 1 
4 4 4 4 4 4 4 10 2 2 9 4 4 4 4 4 4 4 4 0 4 4 4 0 4 4 4 0 0 4 4 0 4 4 4 10 2 2 9 4 4 4 4 4 
4 4 4 4 4 4 4 10 2 2 9 4 4 4 4 4 0 4 4 4 4 4 4 4 4 0 4 0 4 4 4 4 4 4 0 10 2 2 9 4 4 0 4 4 
0 4 4 4 4 4 0 10 2 2 9 4 4 4 4 4 4 4 4 4 4 4 0 4 4 4 4 4 4 4 4 4 0 4 4 10 2 2 9 4 4 4 4 0 
4 4 4 0 4 4 4 10 2 2 9 4 4 4 4 0 4 4 0 4 4 4 4 4 4 4 0 4 4 4 4 4 4 4 4 10 2 2 9 4 4 0 0 0 
