0 0 0 4 0 0 0 0 4 0 0 0 0 0 0 0 0 0 0 0 0 0 4 0 11 16 18 7 7 7 7 7 7 7 7 7 7 7 7 7 7 7 7 7 7 7 7 7 7 7 7 
0 0 0 0 0 0 0 0 0 0 0 0 0 0 0 4 0 0 0 4 0 0 0 0 0 11 8 8 8 8 8 8 8 8 8 8 8 8 8 8 8 8 8 8 8 8 8 8 8 8 8 
0 0 0 0 0 4 0 0 0 4 0 0 0 0 0 0 1 1 1 1 1 1 1 1 1 1 1 1 1 1 1 1 1 1 1 1 1 1 1 1 1 1 1 1 1 1 1 1 1 1 1 
0 0 0 0 0 0 4 4 0 0 0 0 0 1 1 1 3 3 3 3 3 3 3 3 3 3 3 1 5 5 5 5 5 5 5 5 5 5 5 5 5 5 5 5 5 5 5 5 5 5 5 
0 0 0 0 0 0 0 0 4 0 0 1 1 3 3 3 3 3 1 1 1 1 1 1 1 3 3 3 1 5 5 5 5 5 5 5 5 5 5 5 5 5 5 5 5 5 5 5 5 5 5 
0 0 0 0 4 0 4 4 0 1 1 3 3 3 3 1 1 1 0 0 0 0 0 0 0 1 1 3 3 1 5 5 5 5 5 5 5 5 6 5 6 5 5 5 5 5 5 6 5 5 5 
0 0 0 4 0 0 0 1 1 3 3 3 1 1 1 0 0 0 0 0 0 0 0 0 0 0 0 1 3 1 5 5 5 5 5 5 6 6 5 5 5 5 5 5 5 5 5 5 5 5 5 
0 0 0 0 0 1 1 3 3 3 1 1 0 0 0 0 0 0 0 0 0 0 0 0 0 0 0 1 3 1 5 5 5 5 5 5 5 5 5 5 5 5 5 5 5 5 5 5 6 5 5 
0 0 0 1 1 3 3 3 1 1 0 0 0 0 0 0 4 0 0 0 0 0 0 0 0 0 0 1 3 1 5 5 5 5 5 5 5 5 5 5 5 5 5 5 5 5 5 6 5 5 5 
0 1 1 3 3 3 0 0 0 0 0 0 0 0 0 0 0 0 0 0 0 0 0 0 0 0 0 1 3 1 5 5 5 5 5 5 5 5 5 5 5 5 5 5 5 5 5 5 5 5 5 
1 3 3 3 1 1 1 1 1 1 1 1 1 1 1 1 1 1 1 1 1 1 1 0 0 0 0 1 3 1 5 5 5 5 6 5 6 5 5 5 5 5 5 5 5 5 5 5 5 5 5 
3 3 1 1 1 1 1 3 3 3 3 3 3 3 3 3 3 3 3 3 3 3 3 1 1 1 0 1 3 1 5 5 5 5 5 5 5 5 5 5 5 5 5 5 5 5 5 5 5 5 5 
3 1 1 3 3 3 3 3 1 0 1 1 1 1 1 1 1 1 1 1 1 1 3 3 3 3 1 3 1 0 5 5 5 5 5 5 6 5 5 5 5 5 5 5 5 5 5 5 5 5 5 
3 3 3 3 1 1 1 1 0 0 0 0 0 0 0 0 0 0 0 0 0 0 1 1 1 3 3 3 1 0 5 5 6 5 5 6 5 5 6 5 5 5 6 6 6 5 6 5 6 6 5 
3 3 1 1 1 1 1 0 0 0 0 0 0 0 0 0 0 0 0 0 0 0 0 0 0 1 3 3 3 0 5 5 5 5 6 5 5 6 6 6 5 6 5 6 5 5 5 5 6 6 5 
3 3 3 3 3 3 3 1 1 1 1 1 0 0 0 0 0 0 0 0 0 1 1 1 1 3 3 3 1 4 5 5 5 5 5 5 5 5 5 5 5 5 5 5 6 6 5 6 5 5 5 
3 3 1 1 1 1 3 3 3 3 3 3 1 1 1 1 1 1 1 1 1 3 3 3 3 3 1 3 1 4 5 5 5 0 0 5 5 6 6 5 6 5 5 5 6 6 5 5 5 5 6 
1 3 3 3 1 1 1 0 1 1 3 3 3 3 3 3 3 3 3 3 3 3 3 3 1 1 1 3 1 0 5 5 0 0 0 0 0 5 6 6 6 6 5 5 6 6 6 5 6 6 5 
4 1 1 3 3 1 1 0 0 0 1 1 1 1 1 1 1 1 1 1 1 1 1 1 0 0 1 3 3 1 5 5 4 0 4 4 0 0 5 5 5 5 5 6 6 6 6 5 5 5 5 
4 4 4 1 3 3 3 1 0 0 0 0 0 0 0 0 0 0 0 0 0 0 0 0 0 0 0 1 3 1 5 5 0 3 4 4 4 0 0 5 4 3 5 5 5 5 5 5 5 3 3 
4 4 4 4 1 1 3 3 3 1 0 0 0 0 0 0 0 0 0 0 0 0 0 0 0 0 0 1 3 1 5 5 4 3 4 4 4 4 4 4 4 3 0 5 3 4 4 4 5 4 5 
4 4 4 4 4 4 1 1 3 3 1 1 0 0 0 0 0 0 0 0 0 0 0 0 0 0 0 1 3 1 5 5 0 3 4 4 4 3 4 4 4 3 4 4 4 3 4 5 5 4 4 
4 4 4 4 4 4 4 4 1 3 3 3 1 1 1 0 0 0 0 0 0 0 0 0 0 0 1 3 3 1 5 5 4 3 4 4 4 3 4 4 4 3 4 4 4 4 3 4 4 4 4 
4 4 4 4 4 4 4 4 4 1 1 3 3 3 3 1 1 1 1 0 0 0 0 0 0 1 1 3 1 4 5 5 4 3 4 3 3 3 3 3 4 3 4 4 4 4 4 3 4 3 3 
4 4 4 4 4 4 4 4 4 4 4 1 1 3 3 3 3 3 3 1 1 1 1 1 1 3 3 3 1 4 5 5 4 3 4 4 4 3 4 4 4 3 4 4 4 4 3 4 4 3 4 
4 4 4 4 4 4 4 4 4 4 4 4 4 1 1 1 3 3 3 3 3 3 3 3 3 3 3 1 4 4 5 5 4 3 4 4 4 3 4 4 4 3 4 4 4 3 4 4 4 3 4 
4 4 4 4 4 4 4 4 4 4 4 4 4 4 4 4 1 1 1 1 1 1 1 1 1 1 1 4 4 4 5 5 0 3 4 4 4 4 4 4 4 3 4 4 3 4 4 4 4 3 4 
4 4 4 4 4 4 4 4 4 4 4 4 4 4 4 4 4 4 4 4 4 4 4 4 4 4 4 4 4 4 5 5 0 3 4 4 4 4 4 4 4 3 4 4 4 4 4 4 4 3 3 
5 5 5 5 5 5 5 5 5 5 5 5 5 5 5 5 5 5 5 5 5 5 5 5 5 5 5 5 5 5 5 5 5 5 5 5 4 4 4 4 4 4 4 4 4 4 4 4 4 4 4 
5 5 5 5 5 5 5 5 5 5 5 5 5 5 5 5 5 5 5 5 5 5 5 5 5 5 5 5 5 5 5 5 5 5 5 5 4 4 4 4 4 5 5 5 5 5 5 5 5 5 5 
4 0 0 4 0 4 4 4 4 4 4 4 4 4 4 4 4 4 4 4 4 4 4 4 4 4 4 4 4 4 4 4 4 4 5 5 5 5 5 5 5 5 4 4 4 4 4 4 4 4 1 
4 4 0 0 4 4 4 4 4 4 4 4 4 4 4 4 4 4 4 4 4 4 4 4 4 4 4 4 4 4 4 4 4 4 5 5 5 5 5 4 4 4 4 4 4 4 4 4 4 4 1 
4 4 0 4 4 0 0 4 4 4 4 4 4 4 4 4 4 4 1 1 1 1 1 1 4 4 4 4 4 4 4 4 1 4 4 4 4 4 4 4 1 4 4 4 1 1 1 4 4 4 1 
4 0 4 4 4 4 0 4 4 4 4 4 4 4 4 4 4 4 1 4 4 4 4 4 4 4 4 4 4 4 4 4 1 1 0 4 0 0 4 4 1 0 0 1 0 4 0 4 0 1 0 
4 4 4 4 4 4 0 4 4 4 4 4 4 4 4 4 4 4 1 4 4 4 4 4 4 4 4 4 4 4 4 4 1 4 1 0 4 4 1 4 1 4 0 1 4 0 0 0 1 0 0 
4 4 4 4 4 4 4 4 4 4 4 4 4 4 4 4 4 4 1 4 4 4 4 4 4 1 1 1 1 1 1 4 1 4 1 0 0 0 1 4 1 4 0 1 4 4 0 0 1 1 1 
4 4 4 4 4 4 4 4 4 4 4 4 4 4 4 4 4 4 1 4 4 4 4 4 4 4 4 4 4 4 4 4 1 4 1 0 4 0 1 4 1 4 1 4 4 0 4 0 4 0 0 
4 4 4 0 0 4 4 0 4 0 4 0 4 0 4 4 4 4 1 1 1 1 1 1 4 4 4 0 4 4 0 0 1 0 1 0 4 0 1 0 1 0 1 0 4 4 4 4 4 4 4 
0 4 0 0 4 0 0 4 4 4 4 0 0 0 4 4 4 4 1 0 0 4 0 0 0 0 4 4 4 0 4 4 1 0 4 1 0 1 0 0 1 4 1 0 4 4 4 0 0 0 4 
0 0 4 4 0 0 4 0 4 4 0 0 0 4 0 4 0 4 1 0 0 4 4 0 4 1 1 1 1 1 1 4 1 0 4 1 4 1 0 0 1 0 1 0 4 4 0 4 4 4 0 
4 4 4 4 0 0 4 0 0 0 0 0 0 0 4 4 0 0 1 0 0 4 4 0 0 4 0 4 4 0 4 4 1 4 0 1 0 1 0 0 1 0 0 1 4 0 4 4 4 0 0 
4 0 0 0 4 4 0 0 4 4 4 0 0 0 4 0 0 0 1 4 0 0 4 0 4 0 0 0 0 0 4 0 1 0 4 1 0 1 0 0 1 0 0 1 4 0 4 0 4 0 0 
0 0 0 0 0 0 0 0 0 0 0 0 0 0 0 0 0 0 1 0 0 0 0 0 0 0 0 0 0 0 0 0 1 0 0 0 1 0 0 0 1 0 0 1 0 0 0 0 0 0 0 
0 0 0 0 0 0 0 4 0 0 0 0 0 0 0 0 0 0 1 1 1 1 1 1 0 0 0 0 0 0 0 0 1 0 0 0 1 0 0 0 1 0 0 0 1 1 1 0 0 0 0 
0 0 0 0 0 0 0 0 0 0 0 0 0 0 0 0 0 0 0 0 4 0 0 0 0 0 4 0 0 0 0 0 0 0 0 0 0 0 0 0 0 0 0 0 0 0 0 0 0 0 0 
1 1 1 1 1 1 1 1 1 1 1 1 1 1 1 1 1 1 1 1 1 1 1 1 1 1 1 1 1 1 1 1 1 1 1 1 1 1 1 1 1 1 1 1 1 1 1 1 1 1 1 
4 0 4 4 0 4 0 4 4 4 4 4 4 4 0 4 4 4 4 4 4 4 4 0 4 4 4 4 0 4 4 4 4 4 0 4 4 4 4 0 4 0 4 4 4 4 0 4 4 4 4 
4 4 4 4 4 0 4 4 4 4 4 4 4 4 0 4 4 0 4 4 4 4 4 4 0 4 4 4 4 4 4 4 4 4 4 4 4 4 0 4 0 4 4 4 4 4 4 4 4 4 4 
4 4 4 4 4 4 4 4 4 4 4 0 4 4 4 0 4 4 4 4 4 4 4 4 0 4 4 4 4 4 4 4 4 4 4 0 4 4 4 4 4 4 4 4 4 4 0 0 4 4 4 
