0 0 0 4 0 0 0 0 4 0 0 0 0 0 0 0 0 0 0 0 0 0 4 0 11 16 18 
0 0 0 0 0 0 0 0 0 0 0 0 0 0 0 4 0 0 0 4 0 0 0 0 0 11 8 
0 0 0 0 0 4 0 0 0 4 0 0 0 0 0 0 1 1 1 1 1 1 1 1 1 1 1 
0 0 0 0 0 0 4 4 0 0 0 0 0 1 1 1 3 3 3 3 3 3 3 3 3 3 3 
0 0 0 0 0 0 0 0 4 0 0 1 1 3 3 3 3 3 1 1 1 1 1 1 1 3 3 
0 0 0 0 4 0 4 4 0 1 1 3 3 3 3 1 1 1 0 0 0 0 0 0 0 1 1 
0 0 0 4 0 0 0 1 1 3 3 3 1 1 1 0 0 0 0 0 0 0 0 0 0 0 0 
0 0 0 0 0 1 1 3 3 3 1 1 0 0 0 0 0 0 0 0 0 0 0 0 0 0 0 
0 0 0 1 1 3 3 3 1 1 0 0 0 0 0 0 4 0 0 0 0 0 0 0 0 0 0 
0 1 1 3 3 3 0 0 0 0 0 0 0 0 0 0 0 0 0 0 0 0 0 0 0 0 0 
1 3 3 3 1 1 1 1 1 1 1 1 1 1 1 1 1 1 1 1 1 1 1 0 0 0 0 
3 3 1 1 1 1 1 3 3 3 3 3 3 3 3 3 3 3 3 3 3 3 3 1 1 1 0 
3 1 1 3 3 3 3 3 1 0 1 1 1 1 1 1 1 1 1 1 1 1 3 3 3 3 1 
3 3 3 3 1 1 1 1 0 0 0 0 0 0 0 0 0 0 0 0 0 0 1 1 1 3 3 
3 3 1 1 1 1 1 0 0 0 0 0 0 0 0 0 0 0 0 0 0 0 0 0 0 1 3 
3 3 3 3 3 3 3 1 1 1 1 1 0 0 0 0 0 0 0 0 0 1 1 1 1 3 3 
3 3 1 1 1 1 3 3 3 3 3 3 1 1 1 1 1 1 1 1 1 3 3 3 3 3 1 
1 3 3 3 1 1 1 0 1 1 3 3 3 3 3 3 3 3 3 3 3 3 3 3 1 1 1 
4 1 1 3 3 1 1 0 0 0 1 1 1 1 1 1 1 1 1 1 1 1 1 1 0 0 1 
4 4 4 1 3 3 3 1 0 0 0 0 0 0 0 0 0 0 0 0 0 0 0 0 0 0 0 
4 4 4 4 1 1 3 3 3 1 0 0 0 0 0 0 0 0 0 0 0 0 0 0 0 0 0 
4 4 4 4 4 4 1 1 3 3 1 1 0 0 0 0 0 0 0 0 0 0 0 0 0 0 0 
4 4 4 4 4 4 4 4 1 3 3 3 1 1 1 0 0 0 0 0 0 0 0 0 0 0 1 
4 4 4 4 4 4 4 4 4 1 1 3 3 3 3 1 1 1 1 0 0 0 0 0 0 1 1 
4 4 4 4 4 4 4 4 4 4 4 1 1 3 3 3 3 3 3 1 1 1 1 1 1 3 3 
4 4 4 4 4 4 4 4 4 4 4 4 4 1 1 1 3 3 3 3 3 3 3 3 3 3 3 
4 4 4 4 4 4 4 4 4 4 4 4 4 4 4 4 1 1 1 1 1 1 1 1 1 1 1 
4 4 4 4 4 4 4 4 4 4 4 4 4 4 4 4 4 4 4 4 4 4 4 4 4 4 5 
